name{coucou}
width{20}
height{20}

actor{O, texture, cube_texture, wall.png, 1, 1, 0}
actor{X, billboard_texture, quad_texture, pillar.png, 0, 0, 1}
actor{A, texture, cube_texture, wall.png, 1, 0, 0}
actor{W, billboard_animated, quad_texture, mul_test.png, 0, 0, 1}

map{
OOOOOOOOOOOOOOOOOOOO
OX                 O
O     OO  OO  OO   O
O     OO  OO  OO   O
O     O        O   O
O X X O   XX   OX XO
OOO OOOO OOOO OOO OO
O X X           X XO
O                  O
O    A             O
O    O    OXO  O   O
O         O    O   O
O         OOOAAO   O
O     X            O
O                  O
O          X X  O  O
O   W       X OOOO O
O           X   O  O
O                  O
OOOOOOOOOOOOOOOOOOOO
}